NO  textures/eagle.xpm
SO  textures/purplestone.xpm
WE  textures/bluestone.xpm
EA  textures/mossy.xpm

F 255,255,255

C 0,0,0

11111111
10010001
10001001
10000101
1N000011
11111111
