NO             NOtextures/simonkraft/wet_sponge.xpm
SO SOtextures/simonkraft/wet_sponge.xpm
WE                   WEtextures/simonkraft/wet_sponge.xpm

EA EAtextures/simonkraft/wet_sponge.xpm
F    11      F164,169,20

C  C153,204,255

111111111
100100001
100010001
100001001
100000101
1E0000011
111111111

