NO             NO-textures/simonkraft/wet_sponge.xpm
SO SO-textures/simonkraft/wet_sponge.xpm
WE                   WE-textures/simonkraft/wet_sponge.xpm

EA EA-textures/simonkraft/wet_sponge.xpm

F       128,0,128

C  153,204,255

111111111
100100001
100010001
1E0001001
100000101
100000011
111111111

