NO             NOtextures/simonkraft/wet_sponge.xpm
SO SOtextures/simonkraft/wet_sponge.xpm
WE                   WEtextures/simonkraft/wet_sponge.xpm

EA EAtextures/simonkraft/wet_sponge.xpm
F    11      F164,169,20

C  C153,204,255


111111
100001
10N001
111111

