NO textures/greystone.xpm
SO textures/greystone.xpm
WE textures/greystone.xpm
EA textures/greystone.xpm
F 164,169,20
C 153,204,255


11111111
1N000001
10111101
101  101
101  101
10111101
10000001
11111111
