NO textures/greystone.xpm
SO textures/greystone.xpm
WE textures/greystone.xpm
EA textures/greystone.xpm
F 164,169,20
C 153,204,255

1111111
1000001
1111001
1000N01
1111111
1 11 11
