1111111
1000001   
1111001
1N00001
1111111
1 11 11

    

