NO  textures/eagle.xpm            
SO  textures/purplestone.xpm
WE  textures/bluestone.xpm
EA  textures/mossy.xpm        
 

F 254   ,    255,255

C 0,0,0

111111111
100000001
100100001
101000101
100000001
111000111
100000001
1000000N1
111111111
