NO textures/blue_wall.xpm
EA textures/deep_wall.xpm
WE textures/ninja_wall.xpm
SO textures/scale_wall.xpm

F 255, 255, 255

C 0,0,0

111111111111
100000000001
100000000001
100000000001
11111D111111
100000000001
100000N00001
111111111111
