NO textures/blue_wall.xpm
EA textures/deep_wall.xpm
WE textures/ninja_wall.xpm
SO textures/scale_wall.xpm

C 231, 133, 234

F 14, 239, 28


11111111111111111111111
10000000000000000000001
100N0000111111D11111111
10000000100000000000001
10010000100000000000001
10000000D00000000000001
10000000100000000000001
10000000111111111111111
111D1111111111111111111
10000000000000000000001
11111111111111111111111
